▼このファイルについて
yukino氏が配布しているmidiファイルにループ処理を施し、oggに変換したものをパッケージしました。


▼オリジナル配布元
SILDRA COMPANY
https://main-sildra.ssl-lolipop.jp/index.php


▼利用規約
マテリアル・コモンズ・ブルー・ライセンス
https://materialcommons.tk/mtcm-b-summary/


▼表示クレジット
編集: fungamemake.com (著作者:SILDRA COMPANY)


▼ファイル名と曲名
基本的にフォルダで分けてありますが、ファイル名の後ろに'_l'がついているものはループ処理されています。


BGM(ループ有):87


ファイル名 - 曲名
0_fool - 0 THE FOOL
19_sun - ⅩⅨ THE SUN
20_judgment - XX JUDGMENT
4_emperor - Ⅳ THE EMPEROR
7_chariot - Ⅶ THE CHARIOT
8_str - Ⅷ STRENGTH 2008
8_str_old - Ⅷ STRENGTH
ac - Airs Carnival -天界の祭り-
across - across the vast expanse of ocean
aki - 秋風薫る君の部屋から
anosaka - あの坂をのぼって
atira - あちらのお客様から
ayasi - 妖しの森
blackj - Black J
breeze - Night Breeze
buriki - ブリキとゴミ
dd - daybreak-dragoon
dis - Distraction
for_e_2 - For my Lover
future - 繁りゆく未来
gc - 
gogo - 春風の午後に
hajimari - はじまり
haru - 遙かなる『君』へ
hikari - 光の轍
hirosi - ヒロシマン
hosi - 星屑と涙
hukuin - 福音
huwa - ふぅわり
jazz - トワイライトカクテル
kaitaku - 開拓者
kareha - 枯葉のステージ
kata - 傾いた人形
kazamidori - 風見鶏の音
kioku - 記憶の郷 -キヲク ノ サト-
ko - 鼓 -ko-
konbanha - 月夜の森でこんばんは
konwaku - 困惑
kouba - 町工場の外れ
kurohune - 黒船来航
kusabi - 楔 -kusabi-
life - life stream
majinai - まじない
make_bed - Work to make bed
mamoru - 守る者のために
match - The Little Match Girl
mete - Metempsychosis
mi_co - Mi-co
mid_re - midnight relaxation
moon2 - 幻の大地 古の月
mugen - 無限回廊
odayaka - 穏やかな朝
omoi - 想い
pandora - Pandora
quay - Quay -Noah's ark-
rara - 赤い鳥 青い鳥
red_blue - root
root - root（ボーカロイドバージョン）
sabi - 錆びた城壁
sai - 砕[-sai-]
sailor_and_girl - 水兵と麦わら少女
samurai - 侍 -samurai-
saru - 過ぎ去る前の未来
sea - seadragon
shirt_and_iron - シャツとアイロン
sinkai - 深海金魚
sinsetu - 親切さん
sitateya - 仕立屋
soba - すぐ傍にある悲しみに
star_rain - 星の雨
story - Silver Dragon Story
syuen - 終焉
tasogare - 黄昏
tegami - 馬車道郵便屋の手紙
touri - 桃鯉 -touri-
tubame - 燕
twilight - twilight
urara - 麗 -urara-
vacances - Beach Vacances
water - Water Dream
wave - うたかたの夢
witch - The magic of witch
yami - 闇の宴
yayoi - 弥生の雨露
youkan - 洋館
youkou - 遠天に舞う紅葉
yuboku - 遊牧民の陽は暮れて
